%%%%%%%%%%%%%%%%%%%%%%
% %%        % %    P %
%    %%%%%% % %%%%%% %
%%%%%%        %      %
%    % %%%%%% %% %%%%%
% %%%% %         %   %
%        %%% %%%   % %
%%%%%%%%%%    %%%%%% %
%          %%       .%
%%%%%%%%%%%%%%%%%%%%%%