%%%%%%%%%%%%%%%%%%%%%%
% %%    ..  % %      %
%    %%%%%% % %%%%%% %
%%%%%%     P  %  . ..%
%    % %%%%%% %% %%%%%
% %%%% %   .     %...%
%  .     %%% %%%   % %
%%%%%%%%%%    %%%%%% %
%.         %%        %
%%%%%%%%%%%%%%%%%%%%%%