%%%%%%%
%    P%
% %%% %
%..%..%
%% . %%
%.  %%%
%%%%%%%