%%%%%%%
%  ..P%
% %%%.%
%..%..%
%%   %%
%.  %%%
%%%%%%%