%%%%%%%
%    P%
% %%% %
%. %  %
%% . %%
% .%%%%
%%%%%%%
