%%%%%%%
%   .P%
% %%% %
%  %  %
%% . %%
%. %%%%
%%%%%%%
